10
. . . .       . . .
. . . .       . . .
. . . .   + + . . .
. @ . .   + +
+       . . .      
+ + + + P . . + + +
+       . . .     +
+         +       +
. . . . . . . . . .
. . . . . . . . . .
