10
    + + + + + + + +
    +             +
. . . . . @ @     +
. . . H H H .     +
. . H . @ . .     +
. H . . . . .     +
. . . . . . .     +
. . . . . . . + + +
. . . . . . .      
. . . . . . .      
不许选,演示图，怪物赢