10
. . . . .          
. . . . .           
. . M . .            
. . . . .            

        . . . . . .
        . . . . . .
        . . . . @ .
        . . . . . .
        . . . . . .
不许选,演示图