10
. . . . . . . . . .
. . . . . . . . . .
. . . . . . . . . .
. . . . . . .      
+ . . . . . .      
+ + + + . @   + + +
+         .       +
+         +       +
  . + + . + + + + +
            S      
