10
          @ + + + +
          I       +
. . . . I I . .   +
. . . I . @ . .   +
. . I . . . . .   +
. . . . . . . .   +
. . . . . . . .   +
          +       +
          +       +
          + + + + +
不许选,演示图，人赢